8x8NL
7x7NL
0000000000000000NL
0000000000000000NL
0000000000000000NL
000000A0A0000000NL
A000000000000000NL
00000000000000A1NL
0000A0A10000A0A0NL
A0A0A0A0A0A0A0A0NL