64x16NL
118x23NL
B0000000000000000000000000000000000000000000000000000000000000000000000000000000000000000000000000B100000000000000000000000000B1NL
B0000000000000000000000000000000000000000000000000000000000000000000000000000000000000000000000000B100000000000000000000000000B1NL
B0000000000000000000000000000000000000000000000000000000000000000000000000000000000000000000000000B100000000000000000000000000B1NL
B0000000000000000000000000000000000000000000000000000000000000000000000000000000000000000000000000B100000000000000000000000000B1NL
B0000000000000000000000000000000000000000000000000000000000000000000000000000000000000000000000000B100000000000000000000000000B1NL
B0000000000000000000000000000000000000000000000000000000000000000000000000000000000000000000000000B100000000000000B10000000000B1NL
B0000000000000000000000000000000000000000000000000000000000000000000000000000000000000000000000000B100000000000000000000000000B1NL
B0000000000000000000000000000000000000000000000000000000000000000000000000000000000000000000000000B100000000000000000000000000B1NL
B0000000000000000000000000000000000000000000000000000000000000000000000000000000000000000000000000B100000000000000B10000000000B1NL
B0000000000000000000000000000000000000000000000000000000000000000000000000000000000000D00000000000B100000000000000000000000000B1NL
B0000000000000000000000000000000000000000000000000000000000000000000000000000000B00000B00000000000B100000000B1000000000000B1B1B1NL
B0000000000000000000000000000000000000000000000000000000000000000000B00000000000000000B00000000000B10000I000B1000000B100000000B1NL
B0000000000000000000000000000000000000000000000000000000000000000000B000000000000000B0B00000000000B1B1B1B1B1B10000000000000000B1NL
B00000000000000000000000000000000000000000000000000000000000000000B0B0D00000D000000000000000000000000000000000000000000000B1B1B1NL
B000000000000000000000000000000000000000D000000000D1000000000000D0B0B0B0B0B0B0B00000000000D0000000000000000000000000000000B1B1B1NL
B0B0B0B0B0B0B0B0B0B0B0B0B0B0B0B0B0B0B0B0B0B0B0B0B0B0B0B0B0B0B0B0B0B0B0B0B0B0B0B0B0B0B0B0B0B0B0B0B0B1B1B1B1B1B1B1B1B1B1B1B1B1B1B1NL