16x16NL
15x15NL
000000000000A0A0A0A000000000A000NL
00000000000000000000000000000000NL
00000000A00000000000000000000000NL
000000A0A00000000000000000000000NL
A0000000000000000000000000A0A0A0NL
00000000000000A10000000000000000NL
0000A0A10000A0A0A000000000000000NL
A0A0A0A0A0A0A0A00000000000000000NL