16x16NL
15x15NL
000000000000B0B0B0B000000000B000NL
00000000000000000000000000000000NL
00000000B00000000000000000000000NL
000000B0B00000000000000000000000NL
B0000000000000000000000000B0B0B0NL
00000000000000D00000000000000000NL
0000B0D000I0B0B0B000000000000000NL
B0B0B0B0B0B0B0B00000000000000000NL